00000000000000000000000000000000000000000
00000000011000000011011111100000000000000
00100000000010010010000000100111000000000
00000001100000100100000000100000000000000
00011000000000001010000000000001000000000
00000101011100010001110000000000001001000
00110100000010010000011111111100100000000
00010000000010000000100000000010010000000
00000000000010001000100000000010010000000
01001011011101110100100000000010010000000
00011000010000000010100000000010000100000
01010110100010000010100000000000011000000
00000000100010000010103000000000100000000
00010000100000010010000000000001000000000
00000100100010010010011010100100000100000
01000110100010010011100000000000111010000
01000000000000000100011100110000000010000
00000110000011000100000000000000000010000
11100111111111000010000000001011001100000
00000000001000100110000001000010011100000
00000010001000111010101110001010000100000
00000010000000000001100000010000000100000
00020010001100001000000000000001011100110
00000010010010000011000101000001000001000
00000010010001000100000100000000000001000
00101010001110101000010000010001000000000
00100110000010101101000000100000001100000
00110011000001010000100001000010011110100
00000010001000001100000100010010000000100
00000010001000000001011000010010000000110
11111000011111100000010000010000001100000
00000000000000000000010000000000000100000
00000000000000000000000000000000000000000
00000000000000000000000000000000000000000
00000000000000000000000000000000000000000
00000000000000000000000000000000000000000
00000000000000000000000000000000000000000
00000000000000000000000000000000000000000
00000000000000000000000000000000000000000
00000000000000000000000000000000000000000
00000000000000000000000000000000000000000
