0000000000000000000000000010100100000000
0000000000000000000000001000000000100000
0000000000000000000000001000000000000000
0000000000000000000000000000000001000000
0000000000000000000000000000000000000000
0000000000000000001100000000000000000000
0000000000000000000001000000001000000000
0000000000000000010000010000001000000000
0000000000001000010000001110100000000000
0000000100000100010100000100010000000000
0000010000000000010000100100010000000000
0000000000110000110000110110000001000000
0000000001000000001100103100000000000000
0000000001000100011100100000000100010000
0000000000100100111100100000000001110000
0000010000000100010010110000000000000000
0000000000000001010001010000000010000000
0010000001000000010110000010000001000000
0000000110000000011110000000000000000000
1000000001010000011100000000000101000000
1000001000012001001100001010110001000000
0000000000000001000101100100001000000000
0001011001010000000100100010000010000000
0000001100001000000100010001111001100000
0000011000000100011100101000000000110000
0000010000000100001000000000000100001000
0000100000000010111000000010010101000000
0010000000000001110010010100000110100000
0000000000001000010011111111101000001000
0000000000000011111111010000000101010000
0100000000000000000000000000000000000110
0000000000000000000000000000000000000000