1111111111111110000000001111111111111100
1000000000000010001111100000001001000000
1011111111110010111000100111000000003000
1010000000010010001110111101111111111111
0011111100010010000010000000000000000000
0010000000110011110010001111111111100111
0010000111100010011010001001000000100100
0010000100000000010000001001011111100100
0111110100001000010011111001010001100111
0100011111111111010000100011010101000000
0100000001000001010000000001000001000000
0000010000001001011111111111111111000000
1111111111101001000001000010001000011001
0000000000101001000000000000001000001000
0000000100111001111111111110001001001000
1111111100000001000000010010000001001000
0000000100100000000100000011111111111111
0000000100111111111111110010000000100001
0111110110100000000000110000010000100000
0100000010100111110010010000010000000100
0100010010100100010010010011111111111100
0001110010100111111110010010001000100111
0001000000000000000011010010000000100000
0001000101111011110010010010111110110010
0001011101001010010010011110100011100011
1111000101001000010010000000100000000110
0000000000001111010011111111100001111110
1111111111111001010001000101111101000000
0000001000000001110000000000000000011100
0002001000100000000010000011111101000000
1000000000100000100010000110000101111111
1111111111111111111111111100010101000000
