0000000000000000000000000000000000000000
0000000010110000000000000000000000000000
0000000010001000010101001000000000000000
0000000100000100010001000010000000000000
0000000000000001010010000000010000000000
0000000000000100100010100000000000000000
0000000000100101000110001011000000000000
0000000000100110010100000001100000000000
0000000000110010001100000000010101100000
0000000000001001110000001000010000101000
0000000000000010100000010000000010000000
0000000001110110000010000000000000000000
0000000011110001110101100000000000000000
0000001011010000000000100001000001100000
0001100000011111100000001000000100000000
0000111000011001100300000001110100000000
0000100001010000100000000000010000000000
0000010101110000100000001010000001001000
0000001111000001100000001001100000000000
0000000100000000111111100000000001010000
0000011000010000000000001001100000000000
0000100000010000010000000000000000100000
0000110000111110010000001011000100001000
0000000111110000000000001000111000000000
0000000001110000110000010000110101100000
0000000200010000001100000001100000000000
0000000000011000000111110001100000000000
0000000000001000000001000010001000000000
0000000000000110000100010000000000000000
0000000000000001010110000111000100000000
0000000000000000000100000000001100000000
0000000000000000000000000000000000000000