0000000000000000000000000000000000000000
0000000001100000001101111110000000000000
0010000000001001001000000010011100000000
0000000110000010010000000010000000000000
0001100000000000101000000000000100000000
0000010101110001000111000000000000100100
0011010000001001000001111111110010000000
0001000000001000000010000000001001000000
0000000000001000100010000000001001000000
0100101101110111010010000000001001000000
0001100001000000001010000000001000010000
0101011010001000001010000000000001100000
0000000010001000001010300000000010000000
0001000010000001001000000000000100000000
0000010010001001001001101010010000010000
0100011010001001001110000000000011101000
0100000000000000010001110011000000001000
0000011000001100010000000000000000001000
1110011111111100001000000000101100110000
0000000000100010011000000100001001110000
0000001000100011101010111000101000010000
0000001000000000000110000001000000010000
0002001000110000100000000000000101110011
0000001001001000001100010100000100000100
0000001001000100010000010000000000000100
0010101000111010100001000001000100000000
0010011000001010110100000010000000110000
0011001100000101000010000100001001111010
0000001000100000110000010001001000000010
0000001000100000000101100001001000000011
1111100001111110000001000001000000110000
0000000000000000000001000000000000010000