00000000000000000000000000101001000000000
00000000000000000000000010000000001000000
00000000000000000000000010000000000000000
00000000000000000000000000000000010000000
00000000000000000000000000000000000000000
00000000000000000011000000000000000000000
00000000000000000000010000000010000000000
00000000000000000100000100000010000000000
00000000000010000100000011101000000000000
00000001000001000101000001000100000000000
00000100000000000100001001000100000000000
00000000001100001100001101100000010000000
00000000010000000011001031000000000000000
00000000010001000111001000000001000100000
00000000001001001111001000000000011100000
00000100000001000100101100000000000000000
00000000000000010100010100000000100000000
00100000010000000101100000100000010000000
00000001100000000111100000000000000000000
10000000010100000111000000000001010000000
10000010000120010011000010101100010000000
00000000000000010001011001000010000000000
00010110010100000001001000100000100000000
00000011000010000001000100011110011000000
00000110000001000111001010000000001100000
00000100000001000010000000000001000010000
00001000000000101110000000100101010000000
00100000000000011100100101000001101000000
00000000000010000100111111111010000010000
00000000000000111111110100000001010100000
01000000000000000000000000000000000001100
00000000000000000000000000000000000000000
00000000000000000000000000000000000000000
00000000000000000000000000000000000000000
00000000000000000000000000000000000000000
00000000000000000000000000000000000000000
00000000000000000000000000000000000000000
00000000000000000000000000000000000000000
00000000000000000000000000000000000000000
00000000000000000000000000000000000000000
00000000000000000000000000000000000000000
