00000000000000000000000000000000000000000
00000000000001000000000000000000000000000
00000000010000100000000000000000000000000
00000001000000001000000000010000000000000
00000001000000001001010001000000000000000
00101001000000000000000000000000000000000
00000101000000000001000000000001000000000
00000000111000001000000000010010101000000
00010010001000000000000000001000000000000
00100000010100001100110000001000000000000
00100000001011100000000010000010000000000
00000000000001000000010000000010000000000
00000000100001010300000010000000000010000
00001001010010000001100000000100000110000
00001001111000000100000000000000000010000
10000011010110000000001000011000000000000
10010010001010001101000010000001001000100
00001001110011110000011000000100010000000
00001000010100100001000000000000000000000
00000100000010010100001000010001001000000
00000000000001010000100100010100000000000
00011000000010000100100000110000000010010
01000000001000000010000010001010000000000
00000020000001111001000000110000100010000
10000000000100000001111000010000000010000
00000000000010010011101000100000000000000
00000000100000010001000100100010000000000
00100100101000000000000001000001100000000
00000000000010011101000100000000000000000
00000101011110100000000111110000000000000
00000000000000000000001000001111000000000
00000000000000000000000000000000000000000
00000000000000000000000000000000000000000
00000000000000000000000000000000000000000
00000000000000000000000000000000000000000
00000000000000000000000000000000000000000
00000000000000000000000000000000000000000
00000000000000000000000000000000000000000
00000000000000000000000000000000000000000
00000000000000000000000000000000000000000
00000000000000000000000000000000000000000
