0011100100000000000000000000000000000000
0000010101100000001101111110000001110000
1110010000001001001000010010011100010000
0000000110000010010000010010000000001100
0001100000000010101000000000100100000000
0000010101110111000011000001000000100100
0011010000110011011001111011110010000000
0001000100001010001010100010001001010100
0000000000001000100010101010001001011110
0100101101110111111010001110001001000010
0001100001000010001011100011011000010000
0101011010001000011010000110000001110001
0000000010111100001010300010001110011101
0001000010000001001010000010000100000001
0000010010001001011011111110010000010001
0100011011001001001110000100000011101011
0100000000000000010001110111001000001110
0000011001001101010000100000001000001000
1110011111111100001000100000101100110000
0110000000100010011000001100001001110000
0000011000100011101010111000101000011100
0000011000000110000110000001000000010000
0002001100110000100000001001100101110011
0000001001001000001100011100000100100100
0000111001000100010000010000000000100100
0010101000111010100001000001000100000000
0010011000001010110100000010000000110000
0011001100000101000010011100011001111010
0000001000100000110000010001001001000010
0000001000100000000101100001001000000011
1111100001111110000001000001100000110000
0000000000000010000111000000000000010000