00111001000000000000000000000000000000000
00000101011000000011011111100000011100000
11100100000010010010000100100111000100000
00000001100000100100000100100000000011000
00011000000000101010000000001001000000000
00000101011101110000110000010000001001000
00110100001100110110011110111100100000000
00010001000010100010101000100010010101000
00000000000010001000101010100010010111100
01001011011101111110100011100010010000100
00011000010000100010111000110110000100000
01010110100010000110100001100000011100010
00000000101111000010103000100011100111010
00010000100000010010100000100001000000010
00000100100010010110111111100100000100010
01000110110010010011100001000000111010110
01000000000000000100011101110010000011100
00000110010011010100001000000010000010000
11100111111111000010001000001011001100000
01100000001000100110000011000010011100000
00000110001000111010101110001010000111000
00000110000001100001100000010000000100000
00020011001100001000000010011001011100110
00000010010010000011000111000001001001000
00001110010001000100000100000000001001000
00101010001110101000010000010001000000000
00100110000010101101000000100000001100000
00110011000001010000100111000110011110100
00000010001000001100000100010010010000100
00000010001000000001011000010010000000110
11111000011111100000010000011000001100000
00000000000000100001110000000000000100000
00000000000000000000000000000000000000000
00000000000000000000000000000000000000000
00000000000000000000000000000000000000000
00000000000000000000000000000000000000000
00000000000000000000000000000000000000000
00000000000000000000000000000000000000000
00000000000000000000000000000000000000000
00000000000000000000000000000000000000000
00000000000000000000000000000000000000000
