0000000000000000000000000000000000000000
0000000000000100000000000000000000000000
0000000001000010000000000000000000000000
0000000100000000100000000001000000000000
0000000100000000100101000100000000000000
0010100100000000000000000000000000000000
0000010100000000000100000000000100000000
0000000011100000100000000001001010100000
0001001000100000000000000000100000000000
0010000001010000110011000000100000000000
0010000000101110000000001000001000000000
0000000000000100000001000000001000000000
0000000010000101030000001000000000001000
0000100101001000000110000000010000011000
0000100111100000010000000000000000001000
1000001101011000000000100001100000000000
1001001000101000110100001000000100100010
0000100111001111000001100000010001000000
0000100001010010000100000000000000000000
0000010000001001010000100001000100100000
0000000000000101000010010001010000000000
0001100000001000010010000011000000001001
0100000000100000001000001000101000000000
0000002000000111100100000011000010001000
1000000000010000000111100001000000001000
0000000000001001001110100010000000000000
0000000010000001000100010010001000000000
0010010010100000000000000100000110000000
0000000000001001110100010000000000000000
0000010101111010000000011111000000000000
0000000000000000000000100000111100000000
0000000000000000000000000000000000000000