00000000000000000000000000000000000000000
00000000101100000000000000000000000000000
00000000100010000101010010000000000000000
00000001000001000100010000100000000000000
00000000000000010100100000000100000000000
00000000000001001000101000000000000000000
00000000001001010001100010110000000000000
00000000001001100101000000011000000000000
00000000001100100011000000000101011000000
00000000000010011100000010000100001010000
00000000000000101000000100000000100000000
00000000011101100000100000000000000000000
00000000111100011101011000000000000000000
00000010110100000000001000010000011000000
00011000000111111000000010000001000000000
00001110000110011003000000011101000000000
00001000010100001000000000000100000000000
00000101011100001000000010100000010010000
00000011110000011000000010011000000000000
00000001000000001111111000000000010100000
00000110000100000000000010011000000000000
00001000000100000100000000000000001000000
00001100001111100100000010110001000010000
00000001111100000000000010001110000000000
00000000011100001100000100001101011000000
00000002000100000011000000011000000000000
00000000000110000001111100011000000000000
00000000000010000000010000100010000000000
00000000000001100001000100000000000000000
00000000000000010101100001110001000000000
00000000000000000001000000000011000000000
00000000000000000000000000000000000000000
00000000000000000000000000000000000000000
00000000000000000000000000000000000000000
00000000000000000000000000000000000000000
00000000000000000000000000000000000000000
00000000000000000000000000000000000000000
00000000000000000000000000000000000000000
00000000000000000000000000000000000000000
00000000000000000000000000000000000000000
00000000000000000000000000000000000000000
